Date,State,Dead,Injured,Total,Description
31/12/2021,Maryland,0,4,4,An adult and three juveniles were wounded in an evening shooting.
31/12/2021,California,0,6,6,Six shoppers were wounded at a grocery supermarket by two shooters.
31/12/2021,Mississippi,4,3,7,"During an outdoor New Year's Eve party, a physical fight started escalated to a shooting, with multiple people firing guns."
30/12/2021,Pennsylvania,0,6,6,Six shooters opened fire on a busy street with six wounded.
30/12/2021,Missouri,2,2,4,An adult and infant were killed and two adults wounded in an afternoon shooting.
27/12/2021,Alabama,1,3,4,A man was killed and three others wounded at a local gas station.
27/12/2021,Colorado,6,2,8,A gunman went on a shooting spree across multiple locations in the Denver metropolitan area before dying in a shootout with police.
27/12/2021,Ohio,1,3,4,A man was killed and three others were wounded at a local apartment complex.
26/12/2021,New York,0,4,4,Four adults were wounded inside a pop-up store.
26/12/2021,Virginia,1,4,5,"Four people were wounded at a rest stop, and the shooter fled before police arrived. The shooter was later found dead."
26/12/2021,Texas,3,1,4,Three teenagers were killed and a fourth wounded in a convenience store.
26/12/2021,Mississippi,0,7,7,Seven people were wounded at a party in the early morning. An 18-year-old was later arrested.
26/12/2021,Pennsylvania,0,4,4,Four people were wounded in a drive by shooting in North Philadelphia.
25/12/2021,Louisiana,0,4,4,Four people were wounded near a Waffle House in the early morning.
24/12/2021,New York,0,4,4,Four men were wounded outside a Brooklyn deli shortly before midnight.
24/12/2021,Georgia,1,3,4,A woman was arrested after killing one and wounding three in a domestic incident at an apartment.
24/12/2021,Pennsylvania,0,6,6,"Six people were found wounded in a local home, with one identified as the potential shooter."
19/12/2021,Illinois,1,3,4,One man was killed and three others were wounded in a shooting across the street from a strip club.
17/12/2021,Maryland,1,3,4,One person was killed and three wounded in Upton.
17/12/2021,Virginia,0,4,4,Four adults were wounded in the early morning at a gentleman's club.
17/12/2021,Maryland,1,4,5,A man was killed and four people wounded in Penn North.
16/12/2021,Alabama,0,4,4,Four people were wounded in an afternoon shooting.
13/12/2021,California,0,4,4,Police were alerted to four wounded by gunfire after an argument escalated through a shotspotter alert.
13/12/2021,Pennsylvania,0,4,4,"Four adults were wounded in Kengsington, they were found by patrolling police."
13/12/2021,North Carolina,2,4,6,"Six people in an SUV were shot at in the early morning, causing the SUV to crash. Two adults were killed and four juveniles wounded."
12/12/2021,Mississippi,0,6,6,Six people were wounded at local sports bar in the early morning.
12/12/2021,Florida,0,5,5,"Five people were wounded in the early morning, a suspect was arrested days later."
12/12/2021,Texas,1,14,15,One person was killed and fourteen others wounded in a drive-by shooting at a memorial vigil in Baytown for another shooting victim.
12/12/2021,Virginia,0,4,4,Three security guards and a bystander were shot by a gunman at a nightclub.
11/12/2021,Illinois,1,3,4,"Four adults were shot at a bowling alley at approximately 1 AM, killing a 23-year-old man."
10/12/2021,Michigan,1,3,4,"Three teenagers and a baby were shot while in a car near an intersection, killing a 17-year-old girl."
10/12/2021,Florida,0,5,5,Five people were shot in a drive-by shooting in the Callahan neighborhood.
10/12/2021,North Carolina,0,5,5,Five people were shot in the Grier Heights neighborhood.
09/12/2021,Wisconsin,1,5,6,"Responding officers found one person killed and two wounded, with an additional two wounded found at the hospital."
06/12/2021,Pennsylvania,0,4,4,Three men and a teenager were wounded in Brewerytown.
05/12/2021,Michigan,2,2,4,"Four men were shot by a gunman, two of whom succumbed to their injuries."
05/12/2021,Texas,1,3,4,"A fight broke out in the parking lot of a bar, after a group was ejected. It escalated, with bystanders attempting to intervene. A man walked up and shot at the bystanders killing one and wounding three."
03/12/2021,Tennessee,2,2,4,Two teenagers were killed and a teenager and an infant were wounded in a drive-by shooting at a gas station.
02/12/2021,North Carolina,3,3,6,Responding officers found two adults and a child killed and three adults wounded.
30/11/2021,Michigan,4,7,11,"Oxford High School shooting: A 15-year-old student opened fire at Oxford High School initially killing three students and wounding seven others and a teacher, before being arrested. One of the wounded died a day later. The suspect was charged with four counts of murder and seven counts of attempted murder while his parents, who bought him the gun used in the shooting as an early Christmas present, were charged with four counts of involuntary manslaughter."
30/11/2021,Georgia,4,2,6,Responding officers to a domestic incident were shot at by the suspect. The suspect had killed two women and wounded a child previously. An officer and the suspect were killed and another officer was wounded.
28/11/2021,Maryland,0,7,7,Responding police found six adults and a teenager wounded in East Baltimore.
28/11/2021,Illinois,1,4,5,A teenager was killed and four others wounded at a gas station.
28/11/2021,California,5,0,5,A man killed his four children and his mother in law in their home. He turned himself in to police an hour later and was charged with five counts of murder.
28/11/2021,Colorado,0,5,5,Five youths were wounded in a shooting.
28/11/2021,Pennsylvania,0,4,4,Four people were wounded in an evening shooting in Kingsessing.
27/11/2021,New Jersey,1,3,4,A teenager was killed and three others were wounded after men in a car opened fire in the South Ward.
26/11/2021,Tennessee,3,4,7,"Home invaders killed two teenagers and wounded their mother, two teenage siblings and an adult sibling. One of the assailants was also killed."
25/11/2021,Texas,2,2,4,Two men were killed and two others wounded in a believed targeted drive-by shooting. Eyewitnesses are not cooperating with police.
25/11/2021,South Carolina,0,4,4,Four people were wounded and transported to the hospital in private vehicles.
23/11/2021,Florida,0,4,4,Four people were wounded after a large party was ending. Police believe it connected to another incident near a local hospital.
23/11/2021,Texas,1,3,4,A man was killed and three others wounded shortly before noon. A suspect was arrested.
22/11/2021,North Carolina,2,2,4,Two men were killed and two juveniles were wounded while in a vehicle outside an apartment complex.
21/11/2021,Louisiana,1,4,5,A man was killed and four others were wounded in the parking lots of a local club.
21/11/2021,New Jersey,0,5,5,Four adults and one child were shot during a backyard party.
20/11/2021,California,2,2,4,Two men were killed and two wounded at an apartment complex.
20/11/2021,Illinois,0,4,4,Four people were wounded at a local bar in the early morning.
18/11/2021,Maryland,1,3,4,"One teen was killed, and three other teens were wounded in two separate but related shootings on the same block."
17/11/2021,Illinois,1,3,4,A man was killed and three others wounded in an afternoon shooting.
17/11/2021,New York,0,4,4,Two adults and two teens were wounded in a potentially targeted drive-by in Williamsbridge.
17/11/2021,New York,0,4,4,Four teens were shot during a gunfight near a high school.
17/11/2021,Illinois,0,4,4,Four people were wounded in a drive-by shooting shortly after midnight on the Near West Side.
15/11/2021,New York,0,4,4,Four men were shot outside of a bodega in Harlem.
15/11/2021,Colorado,0,6,6,Six teenagers were wounded in a drive-by shooting at a park located across from a high school.
14/11/2021,Pennsylvania,0,6,6,"Three men and three women were shot, one man critically."
14/11/2021,Missouri,1,5,6,"Two men opened fire at each other at a lounge, wounding five. One of the shooters was killed by responding police."
14/11/2021,Oregon,2,2,4,"Four people were shot, two of the victims fatally.  A man from Klamath Falls was arrested and charged with murder."
14/11/2021,Arizona,4,1,5,"Four men arrived at a trailer park and confronted a homeowner and a guest, leading to the homeowner shooting and killing the four men and the guest being injured by the four attackers."
14/11/2021,Alabama,1,5,6,A man was killed and five others wounded at a gas station in the early morning.
13/11/2021,North Carolina,0,4,4,Four people were wounded after several people opened fire at a party.
13/11/2021,Louisiana,0,4,4,"Four people were wounded at a high school homecoming after-party, after multiple attendees began shooting."
12/11/2021,Virginia,2,2,4,Two children were killed and two adults wounded on the East End.
12/11/2021,Alabama,2,2,4,"Two wounded were found outside a vehicle, where two were found deceased in the backseat. Several weapons were found in the vehicle."
09/11/2021,New York,0,4,4,Four teenagers were wounded in an evening shooting.
09/11/2021,South Dakota,3,2,5,Three adults were killed and an adult and child were wounded after an argument escalated inside a home.
09/11/2021,Louisiana,1,4,5,A man was killed and three adults and a teenager wounded in an ambush-style shooting outside a grocery store.
08/11/2021,Pennsylvania,0,4,4,Three teenagers and an adult were wounded after three of them exited a local store in Feltonville and were chased down the street.
07/11/2021,Wisconsin,1,3,4,A man was killed and three others wounded in the early morning.
06/11/2021,California,2,2,4,Two people were killed and two wounded at a family birthday party.
06/11/2021,Texas,0,6,6,Six people were wounded in the early morning at a large community event.
06/11/2021,California,0,4,4,"Shortly after midnight a man opened fire at a local bar, wounding four."
05/11/2021,California,1,3,4,A man was killed and three wounded in a drive-by shooting in East Oakland.
03/11/2021,Iowa,0,4,4,Four people were wounded in an evening shooting a block away from a middle school.
03/11/2021,Virginia,3,2,5,A man killed three women and wounded two in a targeted domestic dispute. One of the wounded was targeted and the others attempted to help her.
02/11/2021,Alabama,0,4,4,A woman shot and wounded four in a bowling alley after a fight escalated.
01/11/2021,Florida,0,4,4,"After an online dispute, a person shot four people in Downtown Orlando."
01/11/2021,Texas,0,4,4,Four people were wounded in an evening drive-by on the West Side.
31/10/2021,Illinois,1,3,4,Four people were shot just after midnight on Halloween.
31/10/2021,Colorado,2,2,4,"Four people were shot, two fatally."
31/10/2021,Texas,1,9,10,A woman was shot and killed and nine injured at a large Halloween party of hundred people.
31/10/2021,Kentucky,2,2,4,Two cousins working as security were shot and killed. Two others were wounded.
31/10/2021,Texas,1,3,4,An 18-year-old was arrested after killing a man and wounding three others in a drive-by shooting.
31/10/2021,Illinois,2,12,14,Two people were killed and several wounded after two men opened fire on a Halloween party.
30/10/2021,California,1,3,4,One person was killed and three wounded after a shooting at a house party. The party occurred at the home of a Gilroy councilwoman.
30/10/2021,Texas,1,9,10,A man was killed and several people wounded after a shooting at a Halloween party.
30/10/2021,Oklahoma,0,4,4,Four people were wounded in a residential area in the early morning.
30/10/2021,Illinois,0,4,4,Four people were wounded at a large house party in the early morning.
30/10/2021,Florida,1,4,5,A man was killed and four others wounded at an outdoor boxing match at the Skyway Plaza.
30/10/2021,California,2,5,7,Two people were killed and five injured at a Halloween party that was held at a local banquet hall.
29/10/2021,Michigan,0,4,4,Four people were shot at a party inside an event center.
29/10/2021,New York,0,5,5,Three people were wounded at a birthday party and two more were wounded as the tour bus transporting some of the wounded was later shot at.
28/10/2021,Nevada,0,4,4,Four people were wounded after an argument in an alley escalated.
28/10/2021,Tennessee,1,3,4,A man was killed and three wounded in a suspected robbery shortly before midnight.
25/10/2021,Idaho,3,4,7,"Two people, including a security guard, were shot and killed at a mall, and four others were wounded. The shooter was injured by responding officers and died the next day after being taken into custody."
25/10/2021,Tennessee,0,4,4,Three teenagers and an adult were wounded after a shooting near an elementary school.
24/10/2021,California,2,2,4,"Two people were killed, and two others injured at an off-roading event."
24/10/2021,Mississippi,2,3,5,Two people were killed and three injured in a shooting on Jones Street.
23/10/2021,South Carolina,0,6,6,Six people were wounded in an early morning shooting at a local bar.
23/10/2021,California,1,4,5,A teenager was killed and one adult and three juveniles wounded at a Halloween party.
23/10/2021,Georgia,1,7,8,A man was killed and seven others wounded at an off-campus party about two blocks from Fort Valley State University.
22/10/2021,Illinois,0,5,5,Five people were wounded outside a Chatham liqueur store when a man opened fire and then fled.
22/10/2021,Washington,0,4,4,Four people were wounded in the parking lot of a banquet hall that was hosting a Halloween party.
22/10/2021,Maryland,0,7,7,Five adults and two teenagers were wounded in a drive-by shooting.
21/10/2021,Washington,4,0,4,Three adults were killed and a fourth later died at the hospital in a night time shooting.
21/10/2021,New York,0,4,4,A gunman exited a subway station and shot four people in the Flatbush section of Brooklyn.
20/10/2021,Michigan,4,0,4,"A woman shot and killed her father, sister and two workers at their home in the afternoon."
19/10/2021,Wisconsin,3,2,5,"A man killed his roommate's teenage daughter and her boyfriend, and wounded his roommate and her 14-year-old son. He later killed himself."
17/10/2021,Texas,0,5,5,Responding officers found an SUV in a ditch with bullet holes and blood near Winzer Park. Four adults and a juvenile were later identified at local hospitals although none had reached out to police.
17/10/2021,Missouri,1,3,4,A 19-year-old was killed and three teenagers were wounded in the early morning in the Baden neighborhood.
17/10/2021,Arkansas,0,4,4,Responding officers found four people wounded and shell casings around a car in the intersection.
17/10/2021,Colorado,0,5,5,Five people were wounded outside a local bar after an unknown number of people opened fire.
17/10/2021,Louisiana,1,7,8,A person was killed and seven others wounded at Grambling State University during a homecoming event in the early morning.
17/10/2021,Wisconsin,0,6,6,Six people were wounded at a one-year anniversary vigil for a man killed in the location. Neighbors refused to cooperate with police due to fear of retaliation.
17/10/2021,Arkansas,1,7,8,"Gunfire erupted at a party hall wounding eleven and killing one, responding police opened fire on a man holding a gun and wounded him."
17/10/2021,Mississippi,3,3,6,Three people were killed and three injured after a man opened fire inside a night club.
16/10/2021,Texas,1,3,4,Four people were wounded in the parking lot of a club in the early morning. One of the wounded died two days later.
15/10/2021,Alabama,0,5,5,Five people were wounded at a high school football game.
14/10/2021,Minnesota,1,4,5,Responding police found five people wounded in Ventura Village. One of the wounded later died at the hospital.
12/10/2021,Florida,1,5,6,A man was killed and three others wounded after two shooters opened fire on a Naples Park home. The shooters were also wounded.
12/10/2021,Mississippi,3,1,4,Three adults were killed in a home and an infant was found wounded.
11/10/2021,Georgia,0,6,6,"Three wounded were found by responding officers, a fourth flagged down officers and two others were found at local hospitals."
10/10/2021,South Carolina,2,3,5,Two people were killed and three injured in a shooting near a nightclub.
10/10/2021,Minnesota,1,14,15,One person was killed and 14 injured in a shootout at a bar.
10/10/2021,Iowa,0,4,4,Four bystanders were wounded at an after hours club  in an early morning targeted shooting.
10/10/2021,Illinois,1,4,5,A man was killed and four others injured in an early morning drive-by outside a Wicker Park nightclub.
10/10/2021,Delaware,1,4,5,A man was killed and four others wounded after a drive-by shooting at a house party in the early morning.
09/10/2021,Texas,0,4,4,Three 18-year-olds and a 16-year-old were wounded in South Dallas.
09/10/2021,New York,1,6,7,Responding officers found one man deceased and six wounded were later found in local hospitals.
09/10/2021,Colorado,1,3,4,Responding officers found one man killed and three wounded.
09/10/2021,Louisiana,2,4,6,Two people were killed and three others wounded after a man went on a multi-parish shooting spree. He was later arrested with a self-inflicted gunshot wound and a dog bite.
08/10/2021,Maryland,0,4,4,Four men were wounded in Southeast Baltimore in the afternoon.
08/10/2021,"Washington, D.C.",1,3,4,"Responding police discovered a deceased man and another wounded, with two more identified at local hospitals."
07/10/2021,Wisconsin,3,1,4,Three adults were killed and another wounded after two men came back thirty minutes after an argument over parking and opened fire.
07/10/2021,Illinois,0,4,4,Two teenagers and two adults were wounded in the early morning after someone opened fire on another car on the Near North Side.
07/10/2021,Wisconsin,0,5,5,Five people were wounded when a police officer opened fire on an armed suspect who returned fire before he fled the area.
06/10/2021,Maryland,1,5,6,A woman was killed and five people were wounded in East Baltimore.
06/10/2021,Ohio,0,4,4,Four adults were wounded at a music studio shortly before midnight.
06/10/2021,Louisiana,1,3,4,A man was killed and three others wounded after four people exited a vehicle and opened fire on them. The victims were doing work in a parking lot behind a church.
05/10/2021,Illinois,1,3,4,Responding police found four injured due to an evening shooting and one later died at the hospital.
05/10/2021,Minnesota,0,4,4,A teen shot four people inside a vehicle at an intersection.
04/10/2021,Minnesota,0,4,4,Three men and a juvenile were wounded at a local gas station.
03/10/2021,South Carolina,1,4,5,A man was killed and four others wounded in an early morning drive by shooting at a Waffle House.
02/10/2021,Colorado,1,3,4,"A man was killed and two adults and a teenager were wounded at an early morning hotel party,"
02/10/2021,Texas,1,3,4,A man was killed and two adults and a teenager wounded at an apartment complex.
01/10/2021,"Washington, D.C.",1,5,6,Five adults were wounded and one killed in Southwest D.C. late at night.
01/10/2021,Iowa,0,6,6,Five adults and a teenager were wounded after an argument at a hotel birthday party celebration escalated.
29/09/2021,Illinois,0,5,5,Five bystanders were wounded when passengers of two separate cars opened fire on one another while driving down a Fulton River District road.
28/09/2021,Illinois,1,3,4,A woman was killed and three others injured in the early morning after a man opened fire on a car in Park Manor.
28/09/2021,Minnesota,1,3,4,A man was fatally shot and three others injured in a gunfire incident on Bloomington Avenue in the Phillips neighborhood.
27/09/2021,Illinois,1,3,4,A man was killed and two adults and a teenager wounded in Humboldt Park on the Northwest Side.
27/09/2021,New York,0,5,5,A man opened fire outside a club in Inwood in Upper Manhattan wounding four. Responding officers opened fire an wounded him.
26/09/2021,Washington,3,3,6,Two groups of people began fighting in a bar and others joined in as it spilled into the parking lot. Some fighters got into cars and opened fire while driving away killing three and wounding three others.
26/09/2021,Illinois,0,6,6,Six adults were wounded in East Garfield Park on the West Side in the early morning.
26/09/2021,California,0,4,4,Four people including a teenager were wounded in East Oakland.
25/09/2021,New York,0,4,4,Four men were wounded in the early morning.
25/09/2021,Tennessee,2,5,7,Responding police found two adults killed and four adults and a child wounded.
25/09/2021,California,0,6,6,Shortly after midnight six people were wounded at a large house party.
25/09/2021,Tennessee,4,0,4,Two adults arrived at a home and engaged in an argument with the four adults there over a 10-month old. The dispute escalated and the four adults living at the home were killed and the two suspects kidnapped the child.
24/09/2021,South Carolina,4,1,5,A man murdered his parents and sister and wounded another sibling before committing suicide.
24/09/2021,California,0,4,4,Four people were wounded at the Rosa Parks Metro Station in Willowbrook.
23/09/2021,Tennessee,2,14,16,"Collierville Kroger shooting: A worker at a third-party venue inside the store opened fire in a Kroger, killing one and injuring 14, before taking his own life."
23/09/2021,Pennsylvania,0,4,4,Four men were wounded in the Mantua neighborhood.
22/09/2021,North Carolina,2,2,4,Two teenagers were killed and two others injured in a home invasion. Three days earlier a relative of the two deceased had been killed in another home.
21/09/2021,"Washington, D.C.",0,5,5,"A man opened fire and wounded four adults and one child near Alabama Avenue, Southeast."
20/09/2021,California,1,4,5,"A man was killed and four others wounded, with the deceased found behind the wheel of a vehicle."
20/09/2021,Pennsylvania,1,5,6,A man was killed and five others injured in a drive-by shooting in the Fern Rock neighborhood.
20/09/2021,Missouri,1,3,4,"A man was killed and three others wounded while at a vigil for another homicide victim, when a group of people opened fire from a black SUV."
19/09/2021,South Carolina,1,7,7,After an argument escalated someone opened fire shortly after midnight killing one adult and wounding one adult and seven children.
19/09/2021,Florida,0,4,4,"During an argument one of the victims pulled out her gun and pointed it at the ground, after things calmed down she put it away and began to enter a car with her husband, and two children. The man she was arguing with opened fire once they got to the car, wounding her, her husband and two children."
19/09/2021,Texas,2,4,6,Two adults were killed and three others and a teenager wounded shortly after midnight when a man opened fire.
19/09/2021,California,1,3,4,A man was killed and three others wounded in the early morning while outside a club.
19/09/2021,Illinois,0,5,5,"Five people were wounded while sitting on a porch in Austin during the early morning, after two men exited a vehicle and opened fire."
19/09/2021,New York,2,2,4,"Two people were killed and two injured after someone shot down an alley at a group standing outside, who were attending a party. The shooting occurred on the anniversary of a similar mass shooting in 2020."
18/09/2021,New York,1,3,4,"A man was killed and three others wounded at a BBQ at Claremont Park in the Bronx, after an argument escalated."
18/09/2021,Illinois,2,2,4,Two people were killed and two wounded at a liquor store in the early morning.
18/09/2021,New York,0,4,4,Four people were shot outside a club in the East Flatbush area of Brooklyn after a dispute.
18/09/2021,Louisiana,0,5,5,Five family members were injured after a gunman opened fire on their mobile home at night.
17/09/2021,Georgia,0,4,4,Four people were wounded in the early morning at a night club. Two men were later arrested.
14/09/2021,Maryland,0,4,4,Three teenagers and a boy were injured in a shooting.
14/09/2021,Ohio,0,6,6,Six people were wounded after an incident at a liquor store escalated.
13/09/2021,Wisconsin,0,5,5,Five people were wounded in a shooting at a candlelight vigil near the intersection in Sherman Park. The vigil was held for a 16-year-old who was killed at the same intersection earlier that day.
12/09/2021,Minnesota,4,0,4,"An SUV with four deceased adults was found in a local cornfield in Wheeler, Wisconsin. It was discovered later that the four victims were shot in Saint Paul following an argument at a bar with the shooter. The perpetrator's father followed his son in a vehicle on the way to Wheeler and then gave his son a ride home after his son abandoned the SUV in the cornfield."
12/09/2021,Texas,0,4,4,Four people were found wounded from a shooting.
12/09/2021,Michigan,2,4,6,Two women were killed and four others wounded in a drive-by shooting that targeted a family birthday party.
12/09/2021,Illinois,2,2,4,"Three people were found wounded on the street by police, and a fourth victim was located after he fled to the hospital. Two of the victims perished at the hospital."
11/09/2021,Alabama,0,5,5,Five teenagers were wounded at a party at a local shopping center.
11/09/2021,Illinois,1,3,4,A man was killed and three others injured in South Side drive-by shooting.
11/09/2021,Illinois,1,5,6,A woman was killed and four adults and a teenager wounded in a West Pullman drive-by while walking as a group.
11/09/2021,New Jersey,0,4,4,Responding officers discovered two wounded from an early morning shooting. Two others arrived were identified at the hospital.
11/09/2021,New York,0,4,4,Responding officers found four men wounded.
10/09/2021,Florida,0,4,4,"Deputies were called after a man got drunk and fired shots into the air. He then opened fire on the security guard and officers, before driving down the road, getting into a car accident and opening fire on those in the car. He wounded the security guards and three in the vehicle."
09/09/2021,Illinois,0,7,7,Six adults and a child were wounded in a drive-by shooting. The suspects attempted to flee the area but were hit by a MetroLink train.
09/09/2021,Alabama,1,3,4,Responding officers found one child deceased and two adults and another child injured.
08/09/2021,Missouri,0,4,4,Four people were wounded after two men got into an argument after one was seen arguing and pistol whipping a woman.
07/09/2021,Kansas,1,5,6,"After getting kicked out of a night club shortly after midnight, a man opened fire killed a man and wounded five women."
07/09/2021,Delaware,0,4,4,Four people were wounded in a local park in the Southbridge neighborhood after a drive-by shooting.
06/09/2021,Georgia,0,5,5,"A man opened fire after an argument at a local Black Pride festival, wounding five."
05/09/2021,Michigan,0,4,4,Four men were injured in a shooting outside a rollerskating rink on Eight Mile Road in the west side.
05/09/2021,Missouri,0,4,4,An adult and three teenagers were wounded at a local festival after two people got into an argument and one opened fire.
05/09/2021,New York,0,4,4,Four adults were wounded outside a catering hall in the Bronx after an argument escalated.
05/09/2021,Missouri,0,4,4,Four adults were wounded at a family car show after two men opened fire on the crowd in suspected gang violence.
05/09/2021,Texas,4,0,4,Firefighters discovered a husband and wife and two children deceased when responding to a house fire. Family members believe the family had been dead for days before the fire.
05/09/2021,Georgia,0,7,7,A man fired into a crowd of people that were fighting in the early morning. He wounded seven and turned himself in the next day.
05/09/2021,Florida,4,2,6,"A former Marine sharpshooter shot and killed three adults, an infant, and a dog and wounded a child inside and outside a home, before engaging in a shootout with police. The shooter was eventually injured in the gunfight and then apprehended."
05/09/2021,Ohio,0,4,4,"Three adults and a teenager were wounded after an argument outside a Mt. Washington home. The victims went inside, before the suspect fired through the door."
04/09/2021,Alabama,2,2,4,Two people were killed and two injured after an argument inside a strip mall store escalated. Three people were arrested and one went on the run.
04/09/2021,Louisiana,1,3,4,"Responding officers found four people injured, with one later dying at the hospital."
04/09/2021,"Washington, D.C.",3,3,6,"Six people were found injured in Northwest DC, with three later dying at a hospital."
04/09/2021,Georgia,1,4,5,A teenager was killed and four others injured while attending a block party.
04/09/2021,Pennsylvania,0,4,4,A teenager shot four people on the street in Homewood South.
04/09/2021,Illinois,0,5,5,Five people were injured in a drive-by shooting in Lawndale shortly after midnight.
03/09/2021,New York,0,4,4,Four adults were wounded in an early morning shooting during an outdoor party.
03/09/2021,Texas,1,3,4,A woman was killed and three others injured in an apartment complex close to US Highway 290 in East Austin.
03/09/2021,Louisiana,1,3,4,"One person was killed and three injured outside a shoe store in a strip mall, after two men exited a car and opened fire."
02/09/2021,New York,0,4,4,Four people were wounded after shooters opened fire on them across the street while they were standing outside a deli.
31/08/2021,North Carolina,2,2,4,A man killed one person and wounded two others before kidnapping a woman and infant. He later killed the woman and left the baby alive in the stolen vehicle and is still on the run.
30/08/2021,Illinois,3,3,6,"A man killed two people and wounded three others in a mobile home park, before being killed by responding police."
29/08/2021,Tennessee,0,5,5,Five people were wounded in an early morning drive by shooting on Jefferson Street.
29/08/2021,Nevada,1,3,4,Three adults were wounded and one was killed near Rainbow Boulevard.
29/08/2021,Wisconsin,0,4,4,An adult and three teenagers were wounded.
28/08/2021,New York,0,5,5,"Responding officers found two wounded men, a wounded teenager and two other adults were later found at hospitals."
28/08/2021,California,0,4,4,"Two groups got into an argument near Belmont Park and a man opened fire, wounding four people."
28/08/2021,Illinois,0,4,4,Four adults were wounded in Douglas Park while attending a large gathering.
27/08/2021,Pennsylvania,1,4,5,"After a football game at a high school, a civilian was injured in a drive-by shooting. Police fired back, which district attorney Jack Stollsteimer says likely hit four people, including an eight-year-old girl who was killed."
27/08/2021,West Virginia,2,2,4,"Two adults and two children were shot, with an adult and child later dying from their injuries."
27/08/2021,California,0,4,4,Four men were found injured in the West Hollywood neighborhood.
26/08/2021,Minnesota,0,7,7,Seven people were wounded just after midnight when two people opened fire at one another.
23/08/2021,Illinois,0,4,4,A teenager and three adults were wounded in a drive by shooting in Uptown.
22/08/2021,Illinois,1,4,5,"A man was killed and three adults and a teenager were wounded in East Garfield Park, about four hours after a previous mass shooting."
22/08/2021,Illinois,1,3,4,A SIU student was killed and three other people wounded at a party hosted at a private residence.
22/08/2021,Oregon,0,5,5,Five men were wounded at a vigil for a man that had been killed in the same location earlier in the day.
22/08/2021,Michigan,1,3,4,One person was killed and three wounded in an early morning shooting.
21/08/2021,Illinois,0,4,4,Four people were wounded in an East Garfield Park drive-by.
21/08/2021,Illinois,1,5,6,"A man was killed and five others wounded while standing in a Calumet Heights parking lot, after two men opened fire from an alley."
20/08/2021,Michigan,1,3,4,One person died and three were injured after a shooting.
19/08/2021,Illinois,0,4,4,Four people were shot in a Bronzeville business.
19/08/2021,Pennsylvania,1,4,5,A drive-by shooting outside a barbershop killed one and wounded four.
19/08/2021,Maryland,1,3,4,A man was killed and three others wounded in an evening shooting.
18/08/2021,Maryland,1,3,4,"A teenager was arrested for allegedly shooting four people on a basketball court, killing a man and wounding three teenagers."
18/08/2021,Ohio,2,4,6,"Two people, including a 10-year-old girl, were killed, and four wounded after a shooting."
18/08/2021,California,0,4,4,Four men were wounded after a shooting in Playa del Ray.
18/08/2021,North Carolina,1,3,4,A man was killed and three injured in a shooting.
17/08/2021,New York,0,5,5,Five men were wounded in a drive-by shooting outside a grocery store in Brooklyn.
16/08/2021,New York,0,8,8,Five women and three men were wounded outside a housing project in Brooklyn shortly after midnight.
16/08/2021,Michigan,1,3,4,A man was killed and three others injured outside a local bar.
15/08/2021,Texas,3,2,5,"Three people were killed and two injured after a fight escalated in the parking lot of a local sports bar on the East Side, by a man who drew a long gun and shot into the air."
15/08/2021,Illinois,0,4,4,Three men and a woman were wounded standing outside a home shortly after midnight.
14/08/2021,Ohio,0,5,5,Four adults and a teenager were wounded outside a nightclub shortly after midnight.
14/08/2021,Indiana,1,4,5,A man was killed and three adults and a child wounded in a strip mall parking lot in the early morning.
14/08/2021,New York,0,4,4,Four men were wounded in Brooklyn shortly after midnight.
14/08/2021,New Jersey,0,4,4,Responding officers found four wounded in the early morning.
13/08/2021,Nevada,1,6,7,One person was killed and six teenagers wounded after a fight broke out at a local park shortly after midnight.
11/08/2021,Pennsylvania,1,4,5,A man opened fire on a group playing a dice game outside a local bar. One man was killed and four injured.
10/08/2021,Oregon,2,4,6,"Two men, identified as rap-artists connected to the Wu-Tang Clan, were killed and four others wounded, in a potential drive-by shooting."
10/08/2021,Mississippi,2,2,4,A woman and teenager were killed and two other individuals wounded in an evening shooting.
09/08/2021,Michigan,2,4,6,Two teenagers were killed and four others injured at a late-night party at a city park.
09/08/2021,Massachusetts,1,5,6,"A woman was killed and five others were injured in a shooting on Irma Street near the Mattapan/Dorchester border. Police arrived at the scene at about 12:30 a.m. and pronounced the woman dead. On August 24, police charged a 37-year-old man with murder in connection to the shooting."
08/08/2021,Illinois,1,4,5,A security guard and four others were wounded after a man got into an argument with two security guards outside a club on the South Side.
08/08/2021,Louisiana,0,5,5,Five people were shot in the early morning on Bourbon Street. This was the second weekend in a row with a mass shooting in the city.
08/08/2021,Texas,1,5,6,A man was killed and five others wounded after a fight in a night club escalated out of the club and into the parking lot.
08/08/2021,Illinois,1,6,7,"Two men were arguing outside a lounge on the South Side, before it escalated. One of the two was killed, and the other along with five bystanders was injured."
08/08/2021,New York,2,3,5,Two men were killed and three wounded at an outdoor event space in Brooklyn shortly after midnight.
07/08/2021,Alabama,0,4,4,Three men and a woman were wounded shortly after midnight.
07/08/2021,Illinois,0,4,4,Four men were wounded in a drive-by shooting.
07/08/2021,Virginia,0,4,4,Four people were wounded in an early morning shooting in the Neon District.
06/08/2021,Tennessee,0,4,4,"Four people, two on the side walk and two in a vehicle, were wounded in a drive-by shooting in  West Nashville."
04/08/2021,Pennsylvania,0,4,4,Four adults were wounded a block away from Temple University Hospital.
03/08/2021,Illinois,1,3,4,A woman was killed and three others injured in the early morning in a home. Three men walked to the side of the home and shot repeatedly through the windows and walls.
02/08/2021,South Carolina,3,1,4,Two adults and a child were killed and a child wounded in a home. The shooter was arrested in Florida shortly after.
02/08/2021,South Carolina,0,9,9,Nine people were wounded in the early morning at a local dance studio.
01/08/2021,Louisiana,0,5,5,Five adults were wounded in an early morning shooting near Bourbon Street.
01/08/2021,Louisiana,1,3,4,A teenager was killed and two teenagers and an adult were wounded by a teenager in the Central Business District. He was turned in by a family member.
01/08/2021,Texas,1,3,4,A man was killed and three wounded in an early morning shooting. Five suspects were later arrested.
01/08/2021,Rhode Island,0,5,5,Five people were wounded in the parking lot of a Popeyes restaurant in the early morning.
31/07/2021,Ohio,1,4,5,"Five people were wounded in an early morning shooting outside a local bar, and one died later at the hospital. An argument escalated causing a gunfight between multiple people."
31/07/2021,Illinois,0,4,4,Four adults were wounded in an early morning shooting while at a gathering in Jackson Park on the South Side.
31/07/2021,Michigan,2,2,4,Two people were wounded and two killed at a large public gathering.
31/07/2021,New York,0,10,10,"Ten people, including seven bystanders, were wounded in a night-time gang shooting outside a laundromat. The incident took place in North Corona, Queens."
31/07/2021,Indiana,0,5,5,Three adults and two children were wounded outside a funeral home. It is believed an argument escalated inside the building prior.
31/07/2021,Kentucky,0,5,5,Responding officers found five people wounded in an evening shooting.
29/07/2021,Iowa,0,4,4,A feud between the occupants of two vehicles escalated into gunfire injuring three adults and a child.
29/07/2021,Pennsylvania,3,2,5,"After an argument a man shot and killed his parents. He called 911, and stated he wished to turn himself in, but opened fire at responding officers wounding two. He fled the scene in a vehicle that he crashed and was discovered dead due to a self inflicted gunshot wound."
28/07/2021,South Carolina,1,4,5,"Five people were wounded in an afternoon shooting, with one later dying at the hospital."
28/07/2021,"Washington, D.C.",0,4,4,Four adults were wounded in a shooting in Southeast DC.
26/07/2021,Texas,2,3,5,"A shooter killed one and injured three after opening fire at a backyard party, after becoming upset, leaving and returning. He was chased down by partygoers who threw bricks at him in defense, and was pronounced dead by responding police."
25/07/2021,Michigan,0,7,7,Seven people were wounded at a candlelit vigil on the West Side for a hit and run victim. The shooter pulled up in a vehicle and opened fire on the crowd.
25/07/2021,California,5,1,6,"When responding to a hostage situation at a home in Wasco, officers were fired upon by the shooter. Two officers were shot, and one succumbed to their injuries. Three people inside the house were slain by the shooter. The gunman was also killed during the shootout."
25/07/2021,Illinois,0,5,5,"Five men were wounded shortly after midnight while standing in an Austin backyard, after a man entered and opened fire."
25/07/2021,Washington,2,3,5,Two people were killed and three injured after someone opened fire on a group leaving a nightclub.
24/07/2021,Ohio,0,4,4,Four people were wounded in a parking lot in Short North in an early morning.
24/07/2021,Texas,0,6,6,Six people were wounded in an early morning shooting after an argument escalated at an after-hours club.
24/07/2021,Georgia,2,2,4,Two people were killed and two injured shortly after midnight after a fight escalated.
23/07/2021,California,2,4,6,"Two people were killed and four injured inside a parking garage near a local nightclub. Responding officers attempted to stop multiple vehicles leaving the structure, with some carrying shooting victims."
23/07/2021,South Carolina,2,2,4,Two people were killed and two wounded in a drive-by-shooting.
23/07/2021,South Carolina,0,4,4,Four people were wounded in a van after individuals in a pickup truck opened fire in the early morning.
22/07/2021,Texas,1,5,6,One person was killed and five injured outside a local restaurant in a drive-by shooting.
21/07/2021,Illinois,2,3,5,"Ten minutes after an earlier shooting, three teenagers (two would later die) and two adults were wounded in North Lawndale."
21/07/2021,Maryland,1,4,5,A man was killed and four others wounded at a condo complex after an argument escalated.
21/07/2021,Illinois,2,3,5,A 15-year-old and a 16-year-old were killed and three other adults were wounded on a street corner. The 16-year-old died the next day.
21/07/2021,Illinois,0,8,8,"Shortly before midnight someone opened fire on a party bus passing by a gas station in Old Town. Seven people were wounded in the bus, and one while pumping gas."
20/07/2021,Texas,4,0,4,Four adults were killed in a robbery after three men broke into their home. The three men were arrested later the next day.
19/07/2021,Illinois,0,4,4,Four men were injured in Homan Square while standing outside at night.
19/07/2021,New Jersey,0,6,6,A gunman opened fire at a group of people leaving a bar early in the morning. Six people were wounded.
18/07/2021,Ohio,1,3,4,One person was killed and three wounded in a shooting.
18/07/2021,Florida,1,4,5,A man was killed and four others wounded in a drive by shooting outside of a convenience store.
18/07/2021,North Carolina,0,4,4,Four were wounded in a shooting after an argument.
18/07/2021,Arizona,2,4,6,"Two EMTs were injured after a man opened fire on them as they responded to an unrelated medical incident. The man then drove to a nearby structure fire and shot at nearby people, killing a bystander and wounding a firefighter."
18/07/2021,Texas,3,2,5,Responding officers arrived at a motel where a man was threatening to kill others and responding officers. The man shot and killed two adults and wounded two others before being shot and killed by police.
18/07/2021,California,1,3,4,One person died and three were wounded after a shooting outside a nightclub.
17/07/2021,Oregon,1,6,7,A woman was killed and six others were injured in a shooting in Downtown Portland.
17/07/2021,Illinois,0,6,6,Five teenage girls aged 12 to 19 years old were wounded while standing outside a party in Austin on the West Side.
16/07/2021,California,2,4,6,Shortly before midnight two men were killed and four others injured in Old Sacramento near the old train tracks.
16/07/2021,"Washington, D.C.",1,5,6,A six-year-old girl was killed and five adults were injured in a shooting in the nation's capital.
16/07/2021,New Hampshire,0,4,4,Four people were wounded as passengers in a van taking them from a nightclub.
16/07/2021,South Carolina,1,3,4,One person was killed and three injured at Conestee Park after an argument escalated.
16/07/2021,Illinois,1,3,4,One man was killed and three others injured in Austin shortly before midnight.
16/07/2021,Pennsylvania,1,4,5,An adult was killed and three adults and a fourteen-year-old injured in an evening shooting.
15/07/2021,Massachusetts,0,4,4,Officers responding to a ShotSpotter alert discovered four people wounded at the Bromley Heath Projects in Mission Hill.
15/07/2021,Texas,1,3,4,Officers responding to a 911 call were fired upon by a suspect who barricaded themselves in a home. One officer was killed and three injured.
15/07/2021,Missouri,1,4,5,A man was killed and four others injured after an argument and physical fight between multiple motorcycle clubs escalated.
14/07/2021,Illinois,0,5,5,Five adults were wounded outside a food mart in Gresham after three men jumped out of a car and opened fire.
14/07/2021,Illinois,0,5,5,"Five people were wounded in West Garfield Park on the West Side, after a man approached them and opened fire."
14/07/2021,Delaware,2,2,4,A man and teenager were killed and two adults wounded in an evening shooting in the Knollwood neighborhood.
13/07/2021,Indiana,0,4,4,"Four men were wounded in an early morning shooting, three of the four were found in a vehicle."
13/07/2021,Michigan,1,6,7,"A man was killed and six others wounded at a banquet hall, after a shooter opened fire due to an earlier argument. Attendees fired back and wounded the suspect, who was later arrested."
12/07/2021,New Jersey,0,4,4,Four people were wounded in the early morning at a hotel.
12/07/2021,New York,0,4,4,Multiple masked shooters wounded four in Queens after exiting a car and opening fire.
12/07/2021,Pennsylvania,2,3,5,Two men were killed and three injured after a gun fight between two cars in the parking lot of a housing complex.
12/07/2021,California,3,1,4,Three men were killed and one injured after a gunman opened fire at a house party.
11/07/2021,Texas,1,5,6,A man was killed and five others wounded at an activities complex in the early morning.
10/07/2021,Pennsylvania,0,6,6,Six men were wounded after two shooters walked up to them and opened fire shortly before midnight in the North Philadelphia neighborhood of  Hunting Park.
10/07/2021,Massachusetts,0,4,4,"Four people were wounded in Dorchester, neighbors at first believed it was continuing Independence Day celebrations."
10/07/2021,Ohio,1,3,4,A man was killed and a woman and two children were injured at a gas station in a potential incident of domestic violence.
08/07/2021,Connecticut,0,4,4,Four men were wounded by five teenagers who opened fire at the same location they had wounded a woman two days prior. The teenagers were later arrested.
05/07/2021,New York,0,4,4,Three adults and a three-year-old were injured while standing outside in a large group after someone opened fire.
05/07/2021,California,1,3,4,A drive-by shooting left one person dead and three others injured at an illegal fireworks show.
05/07/2021,Illinois,2,4,6,"A shooting in Washington Park left two dead and four injured, including a 12-year-old girl and a 13-year-old boy."
05/07/2021,Ohio,1,11,12,One person was killed and eleven others injured at an Independence Day block party.
04/07/2021,California,0,4,4,"An overnight shooting left four injured, two critically."
04/07/2021,Ohio,2,3,5,Two people were killed and three injured in a shooting at a large teen party at a city park.
04/07/2021,Ohio,0,4,4,Four adults were wounded in an evening shooting.
04/07/2021,Illinois,0,4,4,Two juveniles and two others were injured on Sunday night.
04/07/2021,Nebraska,1,4,5,"A group of people were fired upon in a parking lot, leaving one dead and four injured."
04/07/2021,Illinois,0,4,4,Four people were wounded in a shooting at a rap concert.
04/07/2021,Missouri,0,4,4,"Four adults were wounded at a local club, and all refused to talk with law enforcement about the incident."
04/07/2021,Texas,0,8,8,Eight people were wounded near a local car wash in the early morning.
04/07/2021,Illinois,0,5,5,Two juveniles and three adults were wounded in a shooting.
04/07/2021,Texas,0,5,5,A shooting at an Independence Day gathering in southeast Dallas left at least four people wounded.
04/07/2021,Texas,3,2,5,A shooting at a neighborhood block party left three people dead and two injured.
03/07/2021,North Carolina,3,1,4,Responding officers found three men killed and one injured at a large party in the early morning.
03/07/2021,Pennsylvania,0,4,4,Four adults were wounded in an early morning shooting.
03/07/2021,Georgia,1,3,4,One person was killed and three injured in a shooting at a sports bar.
03/07/2021,Illinois,0,4,4,Shortly before midnight four men were wounded in a drive-by shooting in Gresham.
02/07/2021,Pennsylvania,1,4,5,A man was killed and four others injured after an afternoon shooting in East Mount Airy.
02/07/2021,Virginia,0,4,4,Three teenagers and a six-year-old were injured in an afternoon shooting. A fifteen-year-old was later arrested in connection with the shooting.
02/07/2021,Illinois,1,4,5,"A teenager was killed and four adults, including a pregnant woman were injured at an American Legion after a funeral."
01/07/2021,Illinois,0,7,7,"Unknown assailants fired into a residence in Englewood, injuring seven people including a baby girl."
01/07/2021,South Carolina,2,4,6,"Two people, including the believed shooter, were killed and four injured in a shooting at a local park."
01/07/2021,Virginia,1,3,4,"Responding police officers to shots fired, found one man deceased and an adult and two teenagers injured."
30/06/2021,Illinois,0,4,4,Four teenagers were wounded while walking in Little Village on the West Side in the evening.
30/06/2021,Louisiana,0,4,4,"A car pulled up to another car waiting to turn and opened fire. An adult, ten-month-old, four and fifteen-year olds were all injured."
30/06/2021,Delaware,1,3,4,"A group of people were fired upon, leaving one killed and three injured."
30/06/2021,Texas,3,1,4,Two adults and a six-year-old were killed and a ten-year-old injured in an evening shooting.
28/06/2021,New York,1,3,4,"A man opened fire into a crowded Walmart parking lot, killing one and injuring three."
27/06/2021,Illinois,1,3,4,A man was killed and three others wounded at a night club in the early morning.
27/06/2021,Illinois,1,10,11,A woman died and ten others were injured after three shooters approached them from an alley and opened fire in Marquette Park.
27/06/2021,Illinois,1,5,6,Five adults and a teenager were wounded in a drive-by shooting while standing outside in South Shore. A woman died later at the hospital
27/06/2021,Tennessee,3,1,4,A tenant with a mental disorder killed three and wounded a neighbor in his boarding house.
27/06/2021,North Carolina,0,4,4,"After an argument escalated at a pool party hosted at an apartment complex, four people were wounded."
26/06/2021,Texas,1,3,4,A man was killed and three wounded at a pay-per-view event at a nightclub after a fight broke out.
26/06/2021,Illinois,1,3,4,A man was killed and three others wounded after an argument escalated in the morning in West Rogers Park.
26/06/2021,Alabama,1,3,4,An argument escalated at a funeral service after an outside group refused to turn down music in their car. A man was killed and three others injured.
25/06/2021,Ohio,0,4,4,Two children and two adults were shot in an SUV.
25/06/2021,Illinois,0,4,4,"Shortly before midnight, two men and two women were injured in a drive-by shooting in Park Manor, in which the shooter drove a moped."
25/06/2021,New York,0,5,5,Five people were shot in an early morning drive-by at a graduation party in the Bronx.
24/06/2021,Florida,1,4,5,"Two shooters opened fire at a local American Legion Post, which was hosting a teen party. All five injured were teenagers."
23/06/2021,New York,0,4,4,"Two adults and two children were wounded at the local JFK Park, after a man opened fire."
23/06/2021,Illinois,0,4,4,Four people were shot while standing outside when two shooters opened fire in South Austin.
23/06/2021,Alabama,2,2,4,Two men were found dead and two more injured by responding police officers.
23/06/2021,Illinois,0,4,4,Four motorcycle club members were wounded in Englewood.
21/06/2021,"Washington, D.C.",0,4,4,Minnesota Vikings defensive tackle Jaylen Twyman was shot along with three others while visiting his aunt.
21/06/2021,Missouri,3,4,7,Three people were killed and four injured in a shooting outside a convenience store.
20/06/2021,Virginia,1,3,4,A man was killed and three wounded while leaving Shockoe Bottom after someone opened fire on a group of people.
20/06/2021,Ohio,1,3,4,A woman was killed and three others injured shortly after midnight.
20/06/2021,Colorado,1,4,5,A man was killed and four others wounded during an early morning Juneteenth celebration at a local strip mall.
20/06/2021,Florida,1,10,11,A woman was killed and ten others injured at an annual community Fathers Day celebration. The shooter was shortly arrested.
20/06/2021,California,3,5,8,"Celebrators of a Marimba; a Guatemalan music and dance party, were shot by multiple shooters who fled in vehicles"
20/06/2021,Texas,0,8,8,"Eight people were wounded in a shootout between two groups after an argument escalated. Each group had rented a party space, and two of the injured were children."
20/06/2021,Indiana,1,4,5,A man was killed and four others were wounded in an early morning shooting at a local brewing companies parking lot.
20/06/2021,New Jersey,1,3,4,One man was killed and three others injured while standing on a porch after a bicyclist opened fire.
19/06/2021,California,1,6,7,A man was killed and five others injured at Lake Merritt near the city's Juneteenth celebration.
19/06/2021,Alaska,1,4,5,Four people wounded and one killed in a shooting.
19/06/2021,Louisiana,2,4,6,Two people were killed and four injured in a parking lot after an argument escalated between unknown people and partygoers leaving a concert.
19/06/2021,New Jersey,0,4,4,Responding officers found two wounded men in an early morning shooting. Shortly after two more were identified at a local hospital.
18/06/2021,Minnesota,0,5,5,Shortly before midnight five people were wounded in Dinkytown.
17/06/2021,North Carolina,2,2,4,A shooting killed two and wounded another two.
17/06/2021,Virginia,0,4,4,Four men were wounded in a shooting.
17/06/2021,New Jersey,0,4,4,Four people were wounded in a shooting.
17/06/2021,Arizona,1,12,13,"One person was killed and twelve others injured in eight drive-by shootings in the West Valley area. A male suspect was taken into custody. Of the injuries, three were wounded by gunfire, while nine others sustained indirect injuries, such as shrapnel from broken glass due to a car crash."
16/06/2021,Maryland,1,5,6,"Six people were shot, one fatally, in West Baltimore."
15/06/2021,Illinois,0,5,5,Five people were wounded at West Garfield Park.
15/06/2021,Illinois,5,3,8,Four women were killed and three others injured after gunfire erupted in a South Side residence. Another woman died in a hospital.
15/06/2021,Alabama,2,2,4,A shooting at a Mueller Water Products factory killed two and injured two others.
14/06/2021,Florida,1,3,4,A drive-by shooting on Interstate 95 killed one and injured three.
14/06/2021,Michigan,2,2,4,Two people were killed and two others injured at a city park.
13/06/2021,Ohio,1,5,6,An altercation resulted in a shooting that killed one and injured five others at a racetrack.
13/06/2021,Kentucky,1,3,4,One man was killed and three other people were injured after a shooting in a Newburg neighborhood.
12/06/2021,Ohio,0,4,4,Four people were wounded in a drive-by. Two of the victims were children caught in crossfire.
12/06/2021,Illinois,1,9,10,A shooting in Chatham on the South Side left one dead and nine injured.
12/06/2021,Ohio,3,4,7,Three men were killed while three women and another man were injured in the Kinsman neighborhood.
12/06/2021,Texas,1,13,14,"At least 14 people were shot in Downtown Austin in the early morning hours, leaving one dead. A suspect has been arrested while police are still looking for another."
11/06/2021,Texas,0,5,5,"A shooting left five people injured, including a four-year-old girl."
11/06/2021,North Carolina,1,3,4,A shooting left one man dead and four others injured.
11/06/2021,Georgia,1,7,8,One person was killed and seven others wounded in a shooting at a housing project.
11/06/2021,Washington,2,2,4,Two people were killed and two others hurt in a shooting in White Center near West Seattle.
10/06/2021,Michigan,1,3,4,"A drive by shooting on the west side left one dead and three injured, including a six-year-old boy."
10/06/2021,New York,0,4,4,Four people were wounded in a drive by shooting that was potential gang activity.
08/06/2021,Tennessee,1,4,5,Four people were wounded and one killed in an afternoon shooting. The suspect is known to the victims.
08/06/2021,Tennessee,1,3,4,Three teenagers were wounded and an adult woman was killed after their cars were boxed in by other vehicles and fired upon. A fourth teenager was injured in a car accident as one of the cars attempted to flee the gunfire.
08/06/2021,Texas,0,5,5,"Four people were shot, and a fifth wounded by bullet fragments in the early morning at a bar. The shooting was believed to be in retaliation of three men being denied entry into the bar."
07/06/2021,Ohio,0,6,6,Six people were wounded in an early morning shooting while standing on a porch.
07/06/2021,Florida,3,3,6,"A man killed his girlfriend, and another man, and injured three teenagers in a Florida home. The man committed suicide upon police arrival."
06/06/2021,Florida,3,6,9,Three people were killed and six more injured at a graduation party inside of a restaurant/hookah lounge.
06/06/2021,Missouri,0,4,4,"Three shooters opened fire on a group of teenagers near Kiener Plaza, injuring four."
06/06/2021,North Carolina,0,4,4,Four people were injured by gunfire at a party in a trailer park.
06/06/2021,Oregon,4,0,4,Four people were shot dead at a home in southeast Portland.
06/06/2021,California,0,5,5,Five men were wounded in the Fremont neighborhood in a drive-by shooting.
06/06/2021,Utah,1,4,5,One person was killed and four more injured in a drive-by shooting.
06/06/2021,Illinois,0,8,8,"Two shooters opened fire on a group in Chatham, injuring eight."
05/06/2021,Indiana,2,2,4,Two people were killed and two more injured while exiting a Boston Market earlier in the morning in northeastern Indianapolis.
05/06/2021,Louisiana,0,8,8,Eight people were wounded in an evening shooting while standing outside a vacant hotel.
04/06/2021,Michigan,1,3,4,One person was killed and three injured.
02/06/2021,Delaware,1,3,4,"A shooter opened fire on officers during a domestic dispute in an apartment, injuring three. The shooter was found dead from a self-inflicted gunshot wound the next day."
02/06/2021,Ohio,0,4,4,Four people were shot and one other was seriously injured after being run over by a car outside a bar.
02/06/2021,Arkansas,0,4,4,Police responding to a fight at a local park were then notified of gunfire. Four people were wounded and one of the shooters was arrested after a car chase.
02/06/2021,Ohio,0,6,6,Two people are in custody after six people were injured in an overnight shooting at a wake.
31/05/2021,Missouri,0,4,4,Four men were wounded in a drive-by shooting.
31/05/2021,Ohio,1,4,5,"One person was killed and four others, including two teenagers, were injured in a shooting during a block party."
31/05/2021,New York,0,5,5,Five people were shot in the Bushwick area of Brooklyn.
30/05/2021,Illinois,0,4,4,Four teens injured in drive-by.
30/05/2021,Alabama,1,4,5,One person was killed and four others were injured at a residence.
30/05/2021,Florida,3,20,23,"2021 Hialeah shooting: Three shooters stepped out of a white SUV, using assault rifles and handguns, and opened fire on a billiards club. Some of the gunmen are still at large."
29/05/2021,Texas,2,2,4,"Two people were killed and two others injured in a drive-by shooting, after leaving a memorial service at a North Side bar."
28/05/2021,Missouri,1,3,4,A man was killed and three other people injured shortly before midnight outside a club.
28/05/2021,Florida,1,6,7,"Shortly before midnight, police responded to a ShotSpotter alert in Wynwood where they found one person killed and six injured."
27/05/2021,North Carolina,0,5,5,A drive-by shooting left five people injured.
26/05/2021,California,10,0,10,"2021 San Jose shooting: An employee opened fire at a Santa Clara Valley Transportation Authority (VTA) control center in San Jose, California, killing nine others before committing suicide."
26/05/2021,Illinois,0,4,4,Three teenagers and an adult were wounded in an apartment in the Englewood neighborhood on the South Side. One of the teenagers was pronounced dead before being resuscitated by doctors.
24/05/2021,Michigan,2,2,4,Two people were killed and two others were injured in a shooting while playing basketball.
24/05/2021,Ohio,4,0,4,At least four people were killed at an apartment complex.
24/05/2021,New York,0,4,4,Four people were wounded at a basketball court near a local marina when someone opened fire.
23/05/2021,Illinois,0,4,4,Four men were wounded outside a home in East Garfield Park after a man opened fire in the afternoon.
23/05/2021,New Jersey,0,5,5,A shooting at large gathering left five people injured.
23/05/2021,Virginia,0,4,4,Four people were wounded in an overnight shooting.
23/05/2021,Ohio,3,8,11,Three people were killed and eight injured at a local bar in the early morning.
23/05/2021,Illinois,0,4,4,An overnight shooting at a private party left four people injured.
22/05/2021,Texas,0,4,4,Four people were injured after a shooting at a sports complex.
22/05/2021,Ohio,1,5,6,A 16-year-old was killed and at least five other teenagers were wounded in a shooting at Bicentennial Park.
22/05/2021,Minnesota,2,8,10,"The incident happened in the early morning near a downtown nightclub, after two men opened fire on each other during an argument."
22/05/2021,Indiana,1,4,5,A woman was killed and four others wounded shortly after midnight. An argument had escalated in the parking lot and gunfire struck people inside their apartments.
22/05/2021,South Carolina,1,14,15,A teenager was killed and fourteen injured after a shooting at an unauthorized concert.
22/05/2021,New Jersey,2,12,14,Two people were killed and twelve others injured at a large house party in a targeted attack.
21/05/2021,New York,1,5,6,One person was killed and five others were injured. The injured walked themselves to the hospital.
21/05/2021,New Jersey,2,4,6,Two people were killed and four injured in a late night shooting.
20/05/2021,Indiana,0,4,4,Four people were wounded after a fight escalated into a shooting.
18/05/2021,California,2,5,7,"Seven people were shot on a party bus celebrating a birthday, two fatally. Police have offered a $40,000 reward for information about the suspect(s)."
18/05/2021,California,1,4,5,A pregnant bystander was shot and killed when a fight led to gunfire on a public street and four others were wounded.
17/05/2021,Oregon,0,4,4,Four people were shot on Swan Island in an incident that is described by law enforcement as gang-related.
16/05/2021,Ohio,1,3,4,Responding officers to a fight and shooting call found a man dead and three others wounded at a nightclub.
16/05/2021,Georgia,0,4,4,Four people were wounded leaving the Trap Music Museum in an early morning drive-by shooting.
16/05/2021,Michigan,0,5,5,Five people were shot at a party at an apartment complex.
16/05/2021,Georgia,0,4,4,Four people were wounded in an early morning shooting at a Waffle House.
16/05/2021,Alabama,1,4,5,A suspect in a double homicide opened fire on a SWAT team attempting to carry out a search warrant. The suspect was killed and four officers wounded.
16/05/2021,Georgia,1,5,6,A man was killed and five injured in a drive-by shooting while standing outside a gas station.
15/05/2021,New York,1,4,5,One person was killed and four other were injured in shooting in The South Bronx.
15/05/2021,"Washington, D.C.",1,3,4,A man died and two women and another man were wounded in an afternoon shooting.
15/05/2021,Illinois,2,3,5,Two people were killed and three wounded at an early morning gathering in the Auburn Gresham neighborhood.
14/05/2021,Pennsylvania,0,4,4,Three men and a woman were wounded in an evening shooting in West Philadelphia.
13/05/2021,"Washington, D.C.",0,4,4,"Four men found in two separate locations were wounded after a man left a vehicle and opened fire in Southeast Washington, DC."
13/05/2021,Georgia,2,2,4,Two women died and two others were injured in an apartment shooting.
13/05/2021,Rhode Island,0,9,9,"Nine people were shot in Washington Park. According to police, the shooting is the largest in terms of injured in Providence's history."
12/05/2021,Georgia,1,3,4,One person died and three were injured after a shooting at an apartment complex.
11/05/2021,Maryland,0,4,4,Four people were injured in a shooting at a housing complex in West Baltimore.
10/05/2021,Alabama,0,7,7,Seven people were injured in a shooting at a package store.
09/05/2021,Colorado,7,0,7,2021 Colorado Springs shooting: Six people were killed when a man opened fire at a birthday party in a trailer park. The shooter (Teodoro Macias) took his own life shortly afterwards.
09/05/2021,Arizona,1,7,8,Shortly after midnight a fight broke out at Hyatt Regency Phoenix in Downtown Phoenix with a man was killed and seven others wounded.
08/05/2021,California,0,4,4,Four people were wounded in the parking lot of a night club during the early morning. Responding officers had to break up multiple fights upon arriving.
08/05/2021,California,0,4,4,Four people were wounded in the early morning while standing outside for a gathering near Lake Merritt.
08/05/2021,Michigan,0,4,4,Shortly after midnight four people were wounded in an alley in the city's Westside.
08/05/2021,Maryland,4,1,5,A man killed three people and injured a fourth near a townhouse before setting it on fire. Responding officers shot and killed him. The man was reportedly being watched by the FBI before the incident.
07/05/2021,Missouri,2,3,5,A fight broke out at a large outdoor party resulting in two men being killed and three others wounded.
06/05/2021,New Jersey,0,5,5,Five people were wounded in a drive-by shooting during the evening. Thirty minutes prior another two had been injured in a separate drive-by shooting.
05/05/2021,Illinois,0,4,4,Four people were shot while sitting on a porch in the South Shore neighborhood.
03/05/2021,Michigan,1,4,5,A man died and four others were wounded after a shooting at a house party.
02/05/2021,Ohio,0,4,4,Three men and one woman were injured in an afternoon shooting after a man entered a restaurant and opened fire.
02/05/2021,Pennsylvania,1,3,4,One person died and three others were injured after a shooting in Frankford.
02/05/2021,Maryland,1,3,4,"One person was killed, and three others injured at Carroll Park."
02/05/2021,Illinois,0,5,5,Two men and three women were wounded after a drive-by shooting on the West Side.
02/05/2021,Minnesota,0,4,4,A shooting at a house party left four people injured.
01/05/2021,Florida,1,3,4,A shooting left one person dead and three injured at the Brown Sugar Festival.
01/05/2021,Massachusetts,0,5,5,Five people were shot outside the Clubhouse Lounge.
01/05/2021,Wisconsin,3,1,4,"At a casino on Oneida land, a man shot and killed 2 people, and seriously wounded another, before being shot dead by responding police officers."
01/05/2021,New York,1,4,5,A shooting left at least one dead and four more injured at an outdoor gathering.
01/05/2021,Louisiana,2,4,6,Two people were killed and four more were injured in a shooting.
01/05/2021,Georgia,1,3,4,A teenage girl and three others were wounded in a shooting.
01/05/2021,Delaware,0,4,4,Two men and two women were shot and injured.
29/04/2021,Georgia,1,4,5,One person died and four other people were injured after a shooting at a southwest Atlanta home in a drive-by shooting.
28/04/2021,Florida,0,5,5,Five people were injured during a shooting at a Miami home.
28/04/2021,North Carolina,5,0,5,Two deputies were killed and three other people including a suspected gunman were found dead after a standoff.
27/04/2021,Alabama,1,4,5,A shooting left at least one person dead and four more injured.
27/04/2021,Virginia,2,3,5,A three-month-old and her mother were killed after being caught in the crossfire between two groups. Three others are recovering after being shot.
26/04/2021,Oregon,0,7,7,Seven people were shot during a vigil for a shooting victim.
25/04/2021,Louisiana,0,5,5,A shooting at a Houma nightclub left five people injured.
25/04/2021,Alabama,0,4,4,An overnight shooting left four people injured at an outdoor party.
25/04/2021,Arkansas,1,3,4,A drive-by shooting left one person dead and three others injured at Cheatham Park.
25/04/2021,Missouri,1,3,4,A man is dead and three more are injured after a quadruple shooting in the city's historic jazz district.
25/04/2021,Texas,0,4,4,A shooting that occurred at a local night club left four people injured.
24/04/2021,Louisiana,0,5,5,Five people were wounded in a shooting on Bourbon Street.
22/04/2021,California,1,4,5,A man was arrested after two overnight shootings in downtown San Diego left one person dead and four others injured.
19/04/2021,United States Virgin Islands,2,2,4,"Four people were shot, two fatally, at a housing complex."
19/04/2021,Texas,2,3,5,"Five people were shot, two fatally, in Independence Heights."
19/04/2021,Georgia,0,5,5,"Five people were wounded, one critically, at an apartment complex in southwest Atlanta."
18/04/2021,Alabama,1,4,5,"A shooting over the weekend left four people injured, including juveniles, and one woman dead."
18/04/2021,Louisiana,0,5,5,Five victims have shown up at a Shreveport hospital in connection with a shooting on Hearne Avenue.
18/04/2021,Michigan,1,5,6,"Police were investigating a shooting that wounded five, as well as a fatal car crash nearby, when a man drove through the crime scene and later fired at officers. Officers then fired back, killing the man. It is not known if this man was connected to the earlier shooting."
18/04/2021,Wisconsin,3,2,5,Three people were killed and two injured after a shooting at a tavern.
17/04/2021,Louisiana,0,9,9,Nine people were shot and injured during a 12-year old's birthday party.
17/04/2021,Ohio,1,5,6,A woman was killed and five were wounded after a shooting at a vigil for a homicide victim.
16/04/2021,Michigan,0,4,4,Four people were shot at a vigil on the East Side.
15/04/2021,Indiana,9,7,16,"Indianapolis FedEx shooting: A shooting occurred outside a FedEx facility near Indianapolis International Airport. Nine people were reported dead, including the shooter, who committed suicide. The shooter has been identified as 19-year old Brandon Scott Hole, a former employee of the FedEx facility."
15/04/2021,"Washington, D.C.",0,4,4,Three men and a teenage girl were wounded in Northeast DC.
15/04/2021,Florida,0,5,5,Five people were shot outside an apartment complex. Police say there were four shooters.
15/04/2021,Illinois,0,4,4,Four people were wounded in Humboldt Park.
13/04/2021,Maryland,0,4,4,Four men were shot by at least two people while playing a dice game in East Baltimore.
12/04/2021,Illinois,1,3,4,"Four people were shot, one fatally, on the I-290. In addition, a fifth person was hit by a car."
12/04/2021,Tennessee,1,3,4,A three-year-old girl was shot and killed; a two-year-old girl and two adult males were shot and injured in the Cumberland View apartments of the North Nashville neighborhood.
12/04/2021,Georgia,1,3,4,"During a vehicle pursuit, three police officers were shot and one of the occupants of the suspect vehicle was killed by police."
11/04/2021,Kansas,1,3,4,One man was killed and three others wounded at an Airbnb.
11/04/2021,Washington,0,5,5,Five people were shot in a parking lot.
10/04/2021,Missouri,1,3,4,"A man shot several people at a convenience store. Police say the man knew one of the victims, but the motive is unclear."
10/04/2021,Tennessee,1,4,5,Five people were shot at an auto repair shop.
10/04/2021,Connecticut,0,4,4,Four people were wounded in a shooting.
10/04/2021,Michigan,0,4,4,"A shooting at an Allendale apartment complex near Grand Valley State University injured four people, leaving one critically injured."
09/04/2021,Texas,1,5,6,"Six people were shot, one fatally, during a shootout between two vehicles. Police say the shooting may have been gang related. One of the wounded was in a non-related vehicle, and another was in his home."
08/04/2021,Texas,1,5,6,"A shooting at a cabinet manufacturing store left one person dead, four in critical condition, and one in stable condition. One of the injured is a Texas State Trooper. The suspected shooter is now in custody."
07/04/2021,Wisconsin,2,2,4,"Four people were shot at a Northside gas station, two of them fatally."
07/04/2021,South Carolina,7,0,7,"2021 Rock Hill shooting: Six people, including two children, were killed in a mass shooting at a Rock Hill home. The perpetrator, a former professional NFL player was found dead by suicide in a nearby home."
06/04/2021,Michigan,1,3,4,Four people were shot in the Cornerstone Village neighborhood.
06/04/2021,New York,4,0,4,"A man killed the mother of his child and two of her daughters, then later killed himself at the New York City Housing Authority's Van Dyke Houses Brownsville neighborhood of Brooklyn."
05/04/2021,Illinois,0,7,7,Seven people were injured in a shooting in West Englewood.
05/04/2021,Maryland,0,5,5,Five men were injured in a shooting.
05/04/2021,Texas,6,0,6,Two brothers are suspected to have made a suicide pact before they shot and killed four family members and then fatally shot themselves in a suburban home.
04/04/2021,Louisiana,0,6,6,Two men were arrested for a shooting at a bar that wounded six people.
04/04/2021,Alabama,1,6,7,"A woman was killed at a park, and six others, including a 5-year-old boy, were wounded."
04/04/2021,Texas,0,4,4,Four people were wounded in a drive-by shooting.
03/04/2021,Alabama,0,5,5,Two people were arrested after a shooting injured five people.
03/04/2021,Florida,0,7,7,Seven were wounded after a nightclub shooting.
03/04/2021,North Carolina,3,4,7,"Seven people were shot, three fatally, during a house party."
31/03/2021,California,4,2,6,"2021 Orange, California office shooting: Six people were shot. Four people, including a child, were killed and two hospitalized."
31/03/2021,"Washington, D.C.",2,3,5,Five people were shot in the Congress Heights neighborhood. Two of the victims were killed and three others were injured.
30/03/2021,Texas,0,4,4,Several people were wounded in the Acres Homes area in separate shootings. Houston Police believe the shootings may be connected.
28/03/2021,Maryland,5,1,6,A man killed his parents and two others before setting himself on fire. A fifth person was wounded by gunfire but survived.
28/03/2021,Illinois,0,4,4,Four people were struck by gunfire on a vehicle on Interstate 57.
28/03/2021,Texas,0,4,4,"Four people were injured, two critically, after a shooting at an apartment complex."
28/03/2021,Ohio,0,7,7,Seven people were injured after a shootout at a motorcycle club.
27/03/2021,Illinois,1,3,4,"Four people were shot, one fatally, on a party bus."
27/03/2021,Illinois,0,4,4,Four people were wounded after a shooting in the Austin neighborhood.
27/03/2021,Mississippi,0,6,6,Several people were injured after a shooting at a nightclub.
27/03/2021,Tennessee,3,2,5,"In an early morning shooting in Northern Memphis, three people were killed and two people were injured. Of the injured, a man is in critical condition and a woman is in stable condition."
26/03/2021,Pennsylvania,0,7,7,"Seven people were shot outside a sports bar in Fishtown. Three of the victims are in critical condition, and four are in stable condition."
26/03/2021,Virginia,2,8,8,"Eight people were injured after a fight led to a shooting. Two other shootings, one of which was officer-involved, also occurred that night, though it is unknown if they were related to the original shooting."
26/03/2021,Illinois,1,7,8,One person died and seven others were injured at a party in the Southwest Side of Chicago.
23/03/2021,Georgia,0,4,4,"Four people including a child were injured at the entrance of the Cumberland Mall, although the mall was not evacuated. A similar shooting took place in December 2019."
23/03/2021,Alabama,2,2,4,"Four people, including two high school students, were shot. One of the high school students later died."
22/03/2021,Michigan,1,3,4,"Four people were shot in a vehicle, one fatally."
22/03/2021,Ohio,2,2,4,"Four people were shot at a restaurant, two fatally."
22/03/2021,Colorado,10,2,12,"2021 Boulder shooting: Ten people were killed including a Boulder police officer, in a shooting at a grocery store. The shooter was shot in the leg by responding police."
20/03/2021,Texas,0,5,5,Five people were shot at a nightclub.
20/03/2021,Texas,1,7,8,One person died and seven others were wounded after a shooting at a nightclub.
20/03/2021,Pennsylvania,1,4,5,"Five people were shot, one fatally, at a party in the Nicetown neighborhood."
18/03/2021,Oregon,0,4,4,Four people were hospitalized after a shooting at a motel.
18/03/2021,Louisiana,0,4,4,Four people were shot in the 7th Ward.
17/03/2021,California,0,5,5,Five people were wounded after a drive-by shooting at a vigil. Police say the victims are uncooperative.
16/03/2021,Arizona,4,1,5,Four people died after a shooting at a home. One man was injured and is expected to survive.
16/03/2021,Georgia,8,1,9,"2021 Atlanta spa shootings: A series of mass shootings occurred at massage parlors. Eight people were killed in the incidents and one person was wounded, six victims were women of Asian descent. The suspect was arrested in Crisp County and told police he planned to continue his massacre in Florida."
15/03/2021,Indiana,1,4,5,One person died and four were injured after an overnight shooting in the Northside.
14/03/2021,Florida,0,4,4,Four people were shot outside a banquet hall.
14/03/2021,Illinois,0,4,4,Four people were injured during a robbery in the South Side.
14/03/2021,Illinois,2,13,15,Two people were killed and 13 injured at an early morning party in South Side.
13/03/2021,New York,0,5,5,"Five people were shot at a hookah parlor in Williamsburg, Brooklyn."
13/03/2021,Virginia,2,4,6,Two people were killed and four injured at a parking lot.
13/03/2021,Indiana,4,1,5,"Police found a woman who had been shot and learned there may be other victims at a different home. Police arrived at the home and found four dead, including a child."
13/03/2021,Florida,1,3,4,One person was killed and three injured at an early morning party.
12/03/2021,North Carolina,0,4,4,"Four people, including a minor, were injured in a shooting."
11/03/2021,New Mexico,1,3,4,"Following an argument, a man shot at a car of people, killing one and wounding three."
11/03/2021,South Carolina,1,4,5,One person was killed and four injured outside a motorcycle business.
11/03/2021,Pennsylvania,2,2,4,"Four people were shot in Overbrook, two fatally. One of the deceased was 16-years-old."
10/03/2021,Pennsylvania,0,4,4,Four people were shot in Kensington.
10/03/2021,Texas,3,1,4,Three people were killed and one was injured in Southwest Houston. Two of the victims were 18-years-old.
08/03/2021,Florida,1,3,4,One man died and three people were injured in a shooting. Police believe the shooting was targeted.
07/03/2021,Mississippi,0,4,4,"Three adults and a two-year-old child were injured at a child's birthday party, in a local apartment building. The shooter was arrested the next day."
06/03/2021,California,2,3,5,Two were killed and three injured after a drive-by shooting at a backyard gathering.
06/03/2021,North Carolina,1,4,5,One man was killed and four people were injured in an early-morning shooting.
05/03/2021,California,1,4,5,A shooting at a restaurant killed a man from Pennsylvania and injured four others. Police say the shooting was gang-related.
04/03/2021,"Washington, D.C.",0,5,5,Several people were injured in a shooting at a convenience store in the Southwest section of the district.
03/03/2021,Pennsylvania,1,3,4,One person died and three were injured after a shooting at a tavern.
28/02/2021,Texas,0,4,4,Four people were injured at a parking lot in Northwest Houston. Police say the incident was a case of road rage.
28/02/2021,Ohio,4,2,6,"A man shot and killed his wife and two others, wounding a fourth. He was later shot and injured by police in Detroit and was taken to a nearby hospital and died days later."
28/02/2021,Indiana,0,4,4,Four people were shot at a gas station. One of the wounded was a 7-year-old girl.
28/02/2021,South Carolina,0,4,4,Four people were shot at an apartment complex. The shooting occurred at one of the wounded's apartments.
28/02/2021,Louisiana,0,5,5,"Five people were wounded in a drive-by shooting. Four were outside, and one was in a store."
28/02/2021,Delaware,0,4,4,Four people were wounded in an IHOP parking lot during the early morning.
27/02/2021,Mississippi,0,4,4,Four people were injured after a shooting in South Columbus.
27/02/2021,Mississippi,2,3,5,"A conflict between two men led to a shooting at a birthday party, killing two and injuring three."
26/02/2021,California,1,3,4,"Four were shot, one fatally, after a drive-by shooting outside a market."
26/02/2021,Texas,1,5,6,"Six men were injured at a local car wash, with one man found by police and five others identified at a local hospital."
26/02/2021,Louisiana,0,4,4,Four people were shot and injured on Paige Street.
21/02/2021,North Carolina,0,4,4,Four people were wounded after a shooting at a mobile home park.
21/02/2021,Missouri,1,4,5,One man died and four people were injured after an overnight shooting at a club.
20/02/2021,Pennsylvania,1,3,4,One man died and three people were injured after a shooting at a bowling alley.
20/02/2021,Illinois,1,4,5,One man died and four people were injured after an overnight shooting in Springfield.
20/02/2021,Louisiana,3,2,5,"A man shot and killed two people at a gun store. Several people then engaged the original shooter both inside and outside the store, causing injuries to two more people. It is still unclear whether the original shooter was shot dead by engaging responders or committed suicide."
19/02/2021,Colorado,1,3,4,"Four people were shot, one fatally, at a party. Most of the people at the party were of college-age."
18/02/2021,Louisiana,1,3,4,A man was killed and three others injured inside a barbershop.
17/02/2021,Pennsylvania,0,8,8,"A shooter injured eight people, including a seventeen-year-old, near the Olney Transportation Center."
16/02/2021,Florida,3,1,4,"A man suspected in a homicide shot several family members at a house where his grandmother and great-grandmother lived, killing them and his uncle. A woman with gunshot wounds was able to escape to a neighbor's house for help."
13/02/2021,California,0,6,6,A shooting in Bayview injured six people.
13/02/2021,Indiana,0,4,4,One adult and three juveniles were discovered wounded by gunfire in a vehicle stopped at an intersection.
13/02/2021,North Carolina,1,3,4,One person died and three others were wounded in an early morning shooting.
13/02/2021,California,0,6,6,Six wounded men were found after a Shot Spotter alert in the Old Oakland Historic District. The victims are uncooperative with officers.
11/02/2021,Georgia,1,4,5,"Five people were shot, one fatally in an evening shooting near the Signature Event Center."
10/02/2021,Georgia,0,4,4,Four people were injured during a shootout between two vehicles. Two of the injured were minors.
09/02/2021,Texas,0,4,4,Four men were shot and injured in a drive-by shooting at Acres Homes.
09/02/2021,Minnesota,1,4,5,2021 Buffalo clinic attack: A nurse was killed and four other people were shot and seriously wounded inside of a health care clinic. The perpetrator had made previous threats to commit a mass shooting at the clinic.
08/02/2021,Alabama,0,4,4,Three adults and a juvenile were shot and injured in an evening shooting.
06/02/2021,Louisiana,0,4,4,Three teens and one adult were shot at a house party.
06/02/2021,Washington,1,3,4,A shooting at an illegal club killed one and injured three.
06/02/2021,Tennessee,1,4,5,One man was killed in a shooting at a party while two others were hospitalized. Another two were grazed by bullets but refused treatment.
06/02/2021,Illinois,1,5,6,A shooting at a hotel killed one man and wounded five others.
05/02/2021,Mississippi,3,1,4,A shooting at a club left three people dead and one injured.
05/02/2021,Virginia,2,2,4,"Two were killed in a shooting at a restaurant, while two others were injured. One of the shooters engaged in a gunfight with the police."
05/02/2021,Pennsylvania,1,3,4,"Four men were shot at a hookah lounge, one fatally."
04/02/2021,North Carolina,2,3,5,"During a hostage situation, a man killed a woman and shot three officers. The man was later killed by police."
03/02/2021,Colorado,3,1,4,"A shooter attacked four people at an apartment complex near Fort Carson, killing three."
03/02/2021,Colorado,2,3,5,"Police discovered a wounded man, who told them he had been shot by another man. The shooter was discovered shortly afterward in a home where he killed one and injured two before being killed by a resident of the home."
03/02/2021,Tennessee,1,3,4,One person died in North Memphis and three others were injured in a shooting.
02/02/2021,Oklahoma,6,1,7,"2021 Muskogee shooting: Five children and one adult were shot and killed, and one other adult suffered life-threatening injuries, after a home shooting. The slain adult was the adult brother of the perpetrator."
02/02/2021,Florida,3,3,6,"2021 Sunrise, Florida shootout: Two FBI agents were shot and killed and three others wounded attempting to serve a warrant. The suspect barricaded himself in his home and opened fire before shooting and killing himself."
01/02/2021,New York,1,3,4,A man was killed and a woman and two men injured in the early morning.
30/01/2021,New York,1,4,5,"A woman was shot and killed, and four other people were injured after a shooting."
29/01/2021,Pennsylvania,2,3,5,Two people were killed and three others injured after a shooting outside a club.
28/01/2021,Michigan,1,4,5,"A woman was killed and four others, including a baby boy, were injured in a drive-by shooting."
27/01/2021,California,0,4,4,Four men were wounded in the early morning at an illegal gambling den.
25/01/2021,"Washington, D.C.",1,4,5,A shooting at a market killed a Virginia Union University student and wounded four others in the Southeast section of the nation's capital.
24/01/2021,Nevada,0,5,5,"Five people were hospitalized in a shooting, two in critical condition."
24/01/2021,Indiana,6,1,7,Six people including a pregnant woman were killed and a teen was injured in a shooting at a house on the northeast side of Indianapolis. The teen suspect (Raymond Childs III) is currently in custody.
22/01/2021,Kentucky,0,5,5,Five people were injured in a shooting at a bar. A suspect was arrested.
21/01/2021,California,1,3,4,"One person died during a shoot-out in East Oakland, while three others were injured. The man who died was hit by a stray bullet."
20/01/2021,Louisiana,0,4,4,Four people were injured in a shooting just outside Crowley city limits.
18/01/2021,Pennsylvania,0,4,4,Four people were wounded in a string of connected shootings at three different locations.
17/01/2021,Arizona,0,5,5,Five men were injured during a shooting near a strip mall. Police think there may have been a shootout.
17/01/2021,Arizona,1,6,7,A shooting at a nightclub killed one and injured six.
16/01/2021,Illinois,0,5,5,Four men and a woman were injured in an early morning shooting after an attendee at a house party opened fire.
16/01/2021,California,0,5,5,Five people were wounded after a shooting in the Tenderloin district.
15/01/2021,Pennsylvania,0,4,4,Four teenagers were injured in a shooting in the Logan neighborhood of North Philadelphia.
11/01/2021,Florida,0,4,4,Four teenagers were shot outside an apartment complex in Brownsville in the third mass shooting in Metropolitan Miami in eight days.
09/01/2021,Texas,1,3,4,"A shooting at a nightclub left one person, a teenager, dead, and three others injured."
09/01/2021,Illinois,6,2,8,A shooting that started in Chicago ended in Evanston left five people dead and two injured before the shooter was shot and killed by police.
07/01/2021,"Washington, D.C.",0,5,5,Three men and two boys were wounded in an evening shooting in Columbia Heights.
06/01/2021,Virginia,1,3,4,A man opened fire on his family killing one man and injuring two women and a teenage boy before fleeing. He was discovered later by officers after dying in a car accident.
06/01/2021,Texas,1,3,4,"Three men attempted to break into a home, and engaged in a gunfight with an occupant. The occupant was killed and two adults and a three-year-old girl were injured."
05/01/2021,Florida,0,5,5,A shootout injured five people near a convenience store in the Palm River-Clair Mel area.
04/01/2021,Florida,0,7,7,Seven people were injured in a shooting.
04/01/2021,Louisiana,0,4,4,"Three men and a fifteen-year-old boy were involved in a shoot-out in the 7th ward, and subsequently wounded by gunfire."
03/01/2021,Florida,0,4,4,Four people were wounded outside a nightclub in the evening.
03/01/2021,Florida,0,8,8,"Six adults and two teenagers were wounded at a basketball court in Little River Park in Northwest Miami-Dade, when two people walked up and opened fire."
03/01/2021,Oregon,0,4,4,Four people were wounded at a private party.
03/01/2021,Texas,1,4,5,"A fight broke out, outside a Midtown Houston nightclub and a man opened fire. Three officers working a second job as security were wounded, along with the shooter, and a woman, who was the mother of the shooter, was killed."
03/01/2021,California,2,2,4,Two people were killed and two injured after another approached the group on foot and opened fire in the city's lower Eastside.
03/01/2021,Louisiana,2,3,5,Two groups of men opened fire at one another in the early morning. Two were killed and three wounded in the shooting.
01/01/2021,Illinois,0,4,4,Four people were wounded in an early morning shooting while at home. Police believe the shooting was targeted.
01/01/2021,Iowa,1,4,5,"A woman was killed and four others injured after a shooting occurred at a house party. Multiple guns fired into the house, and attendees fled and drove themselves to different hospitals."
01/01/2021,Texas,1,3,4,A man was killed and three others injured in an early morning shooting at a shopping center.
01/01/2021,Arkansas,0,7,7,Seven people were wounded in an early morning shooting at an event center hosting a New Year's party after two men in a disagreement shot at each other.
